From	To	YH_Ticker
#2 HEATING OIL, NY HARBOR-ULSD - NEW YORK MERCANTILE EXCHANGE	#2 HEATING OIL- NY HARBOR-ULSD - NEW YORK MERCANTILE EXCHANGE	HO=F
#2 HEATING OIL, NY HARBOR-ULSD - NEW YORK MERCANTILE EXCHANGE 	#2 HEATING OIL- NY HARBOR-ULSD - NEW YORK MERCANTILE EXCHANGE	HO=F
ALUMINUM MW US TR PLATTS SWAP - COMMODITY EXCHANGE INC.	ALUMINUM MW US TR PLATTS - COMMODITY EXCHANGE INC.	ALI=F
AUSTRALIAN DOLLAR - CHICAGO MERCANTILE EXCHANGE 	AUSTRALIAN DOLLAR - CHICAGO MERCANTILE EXCHANGE	6A=F
BITCOIN-USD - CBOE FUTURES EXCHANGE	BITCOIN - CHICAGO MERCANTILE EXCHANGE	BTC=F
BRAZILIAN REAL - CHICAGO MERCANTILE EXCHANGE 	BRAZILIAN REAL - CHICAGO MERCANTILE EXCHANGE
BRENT CRUDE OIL LAST DAY - NEW YORK MERCANTILE EXCHANGE 	BRENT CRUDE OIL LAST DAY - NEW YORK MERCANTILE EXCHANGE
BRITISH POUND STERLING - CHICAGO MERCANTILE EXCHANGE 	BRITISH POUND STERLING - CHICAGO MERCANTILE EXCHANGE
CANADIAN DOLLAR - CHICAGO MERCANTILE EXCHANGE 	CANADIAN DOLLAR - CHICAGO MERCANTILE EXCHANGE
COCOA - ICE FUTURES U.S. 	COCOA - ICE FUTURES U.S.
COFFEE C - ICE FUTURES U.S. 	COFFEE C - ICE FUTURES U.S.
COPPER-GRADE #1 - COMMODITY EXCHANGE INC. 	COPPER-GRADE #1 - COMMODITY EXCHANGE INC.
CORN - CHICAGO BOARD OF TRADE 	CORN - CHICAGO BOARD OF TRADE
COTTON NO. 2 - ICE FUTURES U.S. 	COTTON NO. 2 - ICE FUTURES U.S.
CRUDE OIL, LIGHT SWEET - ICE FUTURES EUROPE 	CRUDE OIL, LIGHT SWEET-WTI - ICE FUTURES EUROPE
CRUDE OIL, LIGHT SWEET - NEW YORK MERCANTILE EXCHANGE 	CRUDE OIL, LIGHT SWEET - NEW YORK MERCANTILE EXCHANGE
CRUDE OIL, LIGHT SWEET-WTI - ICE FUTURES EUROPE 	CRUDE OIL, LIGHT SWEET-WTI - ICE FUTURES EUROPE
DJIA Consolidated - CHICAGO BOARD OF TRADE 	DJIA Consolidated - CHICAGO BOARD OF TRADE
DOW JONES INDUSTRIAL AVG- x $5 - CHICAGO BOARD OF TRADE 	DOW JONES INDUSTRIAL AVG- x $5 - CHICAGO BOARD OF TRADE
E-MINI S&P 400 STOCK INDEX - CHICAGO MERCANTILE EXCHANGE 	E-MINI S&P 400 STOCK INDEX - CHICAGO MERCANTILE EXCHANGE
E-MINI S&P 500 STOCK INDEX - CHICAGO MERCANTILE EXCHANGE 	E-MINI S&P 500 STOCK INDEX - CHICAGO MERCANTILE EXCHANGE
EURO FX - CHICAGO MERCANTILE EXCHANGE 	EURO FX - CHICAGO MERCANTILE EXCHANGE
EURO FX/BRITISH POUND XRATE - CHICAGO MERCANTILE EXCHANGE 	EURO FX/BRITISH POUND XRATE - CHICAGO MERCANTILE EXCHANGE
GOLD - COMMODITY EXCHANGE INC. 	GOLD - COMMODITY EXCHANGE INC.
JAPANESE YEN - CHICAGO MERCANTILE EXCHANGE 	JAPANESE YEN - CHICAGO MERCANTILE EXCHANGE
MEXICAN PESO - CHICAGO MERCANTILE EXCHANGE 	MEXICAN PESO - CHICAGO MERCANTILE EXCHANGE
MSCI EAFE MINI INDEX - ICE FUTURES U.S. 	MSCI EAFE MINI INDEX - ICE FUTURES U.S.
NASDAQ-100 Consolidated - CHICAGO MERCANTILE EXCHANGE 	NASDAQ-100 Consolidated - CHICAGO MERCANTILE EXCHANGE
NASDAQ-100 STOCK INDEX (MINI) - CHICAGO MERCANTILE EXCHANGE 	NASDAQ-100 STOCK INDEX (MINI) - CHICAGO MERCANTILE EXCHANGE
NATURAL GAS - NEW YORK MERCANTILE EXCHANGE 	NATURAL GAS - NEW YORK MERCANTILE EXCHANGE
NATURAL GAS ICE HENRY HUB - ICE FUTURES ENERGY DIV	NATURAL GAS HENRY LD1 FIXED - ICE FUTURES ENERGY DIV
NATURAL GAS ICE HENRY HUB - ICE FUTURES ENERGY DIV 	NATURAL GAS HENRY LD1 FIXED - ICE FUTURES ENERGY DIV
NEW ZEALAND DOLLAR - CHICAGO MERCANTILE EXCHANGE 	NEW ZEALAND DOLLAR - CHICAGO MERCANTILE EXCHANGE
NIKKEI STOCK AVERAGE - CHICAGO MERCANTILE EXCHANGE 	NIKKEI STOCK AVERAGE - CHICAGO MERCANTILE EXCHANGE
NIKKEI STOCK AVERAGE YEN DENOM - CHICAGO MERCANTILE EXCHANGE 	NIKKEI STOCK AVERAGE YEN DENOM - CHICAGO MERCANTILE EXCHANGE
PALLADIUM - NEW YORK MERCANTILE EXCHANGE 	PALLADIUM - NEW YORK MERCANTILE EXCHANGE
PLATINUM - NEW YORK MERCANTILE EXCHANGE 	PLATINUM - NEW YORK MERCANTILE EXCHANGE
RUSSIAN RUBLE - CHICAGO MERCANTILE EXCHANGE 	RUSSIAN RUBLE - CHICAGO MERCANTILE EXCHANGE
S&P 500 Consolidated - CHICAGO MERCANTILE EXCHANGE 	S&P 500 Consolidated - CHICAGO MERCANTILE EXCHANGE
S&P 500 STOCK INDEX - CHICAGO MERCANTILE EXCHANGE 	S&P 500 STOCK INDEX - CHICAGO MERCANTILE EXCHANGE
SILVER - COMMODITY EXCHANGE INC. 	SILVER - COMMODITY EXCHANGE INC.
SOUTH AFRICAN RAND - CHICAGO MERCANTILE EXCHANGE 	SOUTH AFRICAN RAND - CHICAGO MERCANTILE EXCHANGE
SOYBEANS - CHICAGO BOARD OF TRADE 	SOYBEANS - CHICAGO BOARD OF TRADE
SUGAR NO. 11 - ICE FUTURES U.S. 	SUGAR NO. 11 - ICE FUTURES U.S.
SWISS FRANC - CHICAGO MERCANTILE EXCHANGE 	SWISS FRANC - CHICAGO MERCANTILE EXCHANGE
TEXAS EASTERN- M3 ZONE (DELIVERED) - ICE FUTURES ENERGY DIV 	TEXAS EASTERN- M3 ZONE (DELIVERED) - ICE FUTURES ENERGY DIV
TEXAS EASTERN- M3 ZONE (DELIVERED) (BASIS) - ICE FUTURES ENERGY DIV 	TEXAS EASTERN- M3 ZONE (DELIVERED) (BASIS) - ICE FUTURES ENERGY DIV
TRANSCO ZONE 6 BASIS - ICE FUTURES ENERGY DIV 	TRANSCO ZONE 6 BASIS - ICE FUTURES ENERGY DIV
TRANSCONTINENTAL GAS- STATION 85 (ZONE 4) - ICE FUTURES ENERGY DIV 	TRANSCONTINENTAL GAS- STATION 85 (ZONE 4) - ICE FUTURES ENERGY DIV
U.S. DOLLAR INDEX - ICE FUTURES U.S. 	U.S. DOLLAR INDEX - ICE FUTURES U.S.
U.S. TREASURY BONDS - CHICAGO BOARD OF TRADE 	U.S. TREASURY BONDS - CHICAGO BOARD OF TRADE
VIX FUTURES - CBOE FUTURES EXCHANGE 	VIX FUTURES - CBOE FUTURES EXCHANGE
WAHA FIN BASIS - ICE FUTURES ENERGY DIV 	WAHA FIN BASIS - ICE FUTURES ENERGY DIV
WAHA HUB - WEST TEXAS DELIVERED/BUYER'S INDEX - ICE FUTURES ENERGY DIV 	WAHA HUB - WEST TEXAS DELIVERED/BUYER'S INDEX - ICE FUTURES ENERGY DIV
WHEAT - CHICAGO BOARD OF TRADE 	WHEAT-SRW - CHICAGO BOARD OF TRADE
WHEAT-HRSpring - MINNEAPOLIS GRAIN EXCHANGE 	WHEAT-HRSpring - MINNEAPOLIS GRAIN EXCHANGE
WHEAT-HRW - CHICAGO BOARD OF TRADE 	WHEAT-HRW - CHICAGO BOARD OF TRADE
WHEAT-SRW - CHICAGO BOARD OF TRADE 	WHEAT-SRW - CHICAGO BOARD OF TRADE
